NO ./texture/eagle.xpm
SO ./texture/redbrick.xpm
WE ./texture/purplestone.xpm
EA ./iamironman/greystone.xpm

F 140,140,140
C 155,255,255

111111111111111111111111
100000000000000000000001
100000000000000000000001
100000000000000000000001
100000000000000000000001
100000000000000000000001
100000000111111100000001
100000011100000111000001
100000010000000001000001
100000010000000001000001
100000010000000001000001
100000010000000001000001
100000010000000001000001
100000011000000010000001
100000000000000000000001
100000000000000000000001
100000000N00000000000001
111111111111111111111111
