NO ./texture/eagle.xpm
SO ./texture/redbrick.xpm
WE ./texture/purplestone.xpm
EA ./texture/greystone.xpm

F 220,100,0
C 225,30,0

        1111111111111111111111111
        1000000000110000000000001
        1011000001110000000000001
        1001000000000000000000001
111111111011000001110000000000001
100000000011000001110111111011111
11110111111111011100000010001
11110111111111011101010010001
11000000110101011100000010001
10000000000000001100000010001
10000000000000001101010010001
11000001110101011111011110N0111
11110111 1100101 101011010001
11110111 1101101 111011111011
11110111 1001101 111011111011
11000111 1000001 111000000111
11111111 1111111 111111111111
